%%%%%%%%%%%%%%%%%%%%%%%%%
%.. P  ....      ....   %
%..  ...  ...  ...  ... %
%..  ...  ...  G..  ... %
%..    ....      .... G %
%..  ...  ...  ...  ... %
%..  ...  ...  ...  ... %
%..    ....      ....  o%
%%%%%%%%%%%%%%%%%%%%%%%%%
