%%%%%%%%%%%%%%
%...%   G%...%
%.%.%%  %%.%.%
%.%..........%
%.%.%%%%%%%.%%
%.....P.....o%
%%%%%%%%%%%%%%
